NO src/assets/wall1.xpm
SO src/assets/wall1.xpm
WE src/assets/wall1.xpm
EA src/assets/wall1.xpm
F 0,35,0
C 0,0,0

111111111111111111111111111111
110000000000001111111111
1111100000000000111111111111111
10011000000000011111100011111
10000000000000000000000001
10000000000000000000000001
10000000000000000000000001
10000000011000000000000101111111
1011000001110000000001111111111
1001000000000000000000010001
11111111101100000111000010001
100000000011000001110111111111
1111011111111101110000001
11110111111111011101010011111111111111
110000001101010111000000000000000000001
10000000000000001100000011111111111111
1000000N00000000110101001
1100000111010101111101111111
1111011111101011011110101001
1111111111111111111111111111
