NO ./path_to_the_north_texture
SO ./path_to_the_south_texture
WE ./path_to_the_west_texture
EA ./path_to_the_east_texture
F 0,100,50
C 0,100,250

1111111111111111111111111111111111
10000000011000000000000101111111
1011000001110000000N001111111111
1001000000000000000000010001
11111111101100000111000010001
100000000011000001110111111111
1111011111111101110000001
11110111111111011101010011111111111111
110000001101010111000000000000000000001
10000000000000001100000011111111111111
1000000000000000110101001
1100000111010101111101111111
1111011111101011011110101001
1111111111111111111111111111
