NO src/assets/color1.xpm
F 134,96,154

WE src/assets/color3.xpm


EA src/assets/color4.xpm

C 255,236,223
SO src/assets/color2.xpm

1  1     111111111111
11101111111
1111    11111
11111 11111
10001 10101
100W01 10001
11111111111