NO src/assets/color1.xpm
SO src/assets/color2.xpm
WE src/assets/color3.xpm
EA src/assets/color4.xpm
F 134,96,154
C 255,236,223

    1111 111111
    1001 100001
    1001 100001
11111001 100001
100W00001000001
100000000000001
111111111111111