NO src/assets/color1.xpm
SO src/assets/color2.xpm
WE src/assets/color3.xpm
EA src/assets/color4.xpm
F 134,96,154
C 255,236,223

11111111111111
10000011000011

111111111001101111
10000011000011
10W10001000001
10000000100001
1111111111111