




NO src/assets/color1.xpm
SO src/assets/color2.xpm
WE src/assets/color3.xpm
EA src/assets/color4.xpm
F 134,96,154
C 255,236,223

1111111111111
1000001100011
1111100100111
1000001110001
100W000100001
1000000000001
1111111111111