




NO src/assets/color1.xpm
SO src/assets/color2.xpm
WE src/assets/color3.xpm
EA src/assets/color4.xpm
F 134,96,154
C 255,236,223

1111 111111111
1001 100000001
1001 111001111
111110011100001
100W0001000001
111 1111111111