




NO src/assets/assets2.xpm
SO src/assets/assets1.xpm
WE src/assets/assets4.xpm
EA src/assets/assets3.xpm
F 0,2,30
C 0,39,50

111111111111111111111111111
100000000000000000000000001
111110000000000000000000011
100000000000000000000000111
100000000000000000000001111
100000000000000000000000011
100000000000000000000000001
100000000000000000000000001
100000000000W00000000000001
100000000000000000000000001
100000000000000000000000001
100000000000100000000000001
100000000000000000000000001
100000000000000000000000001
100000000000000000000000001
100000000000000000000000001
100000001000100100000000001
100000001000100100000000001
100000001000100100000000001
111111111111111111111111111
