NO src/assets/color1.xpm
SO src/assets/color2.xpm
WE src/assets/color3.xpm
EA src/assets/color4.xpm

F 220,111,119
C 225,111,0

11111111111111111111111111
100100010010100100100011
10000000000000000000001
11000000E000100000001111
11111000000110000001
11000000000000001111
111110000000000001
11111000000000011
1110000000011111111
111111000001
11111001011
111111111
1111111