NO src/assets/color1.xpm
SO src/assets/color2.xpm
WE src/assets/color3.xpm
EA src/assets/color4.xpm

F 220,111,119
C 225,111,0

11111111111111111111111111
100000000000000000000011
1000000N0000000000000001
110000000000100000001111
111110000000110000001
11000000000000001111
11111110000000000001
1111111100000000001
1110000000011111111
111111000001
11111001011
111111111
1111111