NO src/assets/color1.xpm
SO src/assets/color2.xpm
WE src/assets/color3.xpm
EA src/assets/color4.xpm

F 220,111,0
C 225,111,0

    1111111 111111
    1000001 100001
111110010011100001
1000001 100001111
100W0001000001
10000000000001
1111111111111